A 0,0,0,0
NO assets/textures       /tiles/wall_north.png
SO assets/textures      /tiles/wall_south.png
WE assets/textures /tiles/wall_west.png
EA assets/textures /tiles/wall_east.png

F 255,0,0
C 0,0,0

11111111                           111111111   111111111    
10S00001                 1         100000001   1000000001      
10111111    111   111    1          11111101   10000000001       
101         101   101    1               101   10000000001
101         101   101    1         111111101   10000000001
101         101   101    1111111         101   10000000001
10111111    111111101    10000001   11111101   10000000001
10000001    100000001    10000001  100000001   1000000001 
11111111    111111111    11111111  111111111   111111111                     


