#Textures
NO assets/textures       /tiles/wall_north.png
SO assets/textures      /tiles/wall_south.png
WE assets/textures /tiles/wall_west.png
EA assets/textures /tiles/wall_east.png

#Colors
F 0,0,0
C 135,206,250
A 135,206,250,2

##Level 1 - [31mHello World[0m

#Tilemap
#
# Writing cub3d was difficult, i almost cried.
# So i let this poem right there to show an exemple of comments :
#
# In self-defense
# A knife protects
# I bring my lunch
# No one suspects
# And when its time
# Deceptive fruit
# Banana Knife
#

11111111                           111111111   111111111    
10S00001                 1         100000001   1000000001      
10111111    111   111    1          11111101   10000000001       
101         101   101    1               101   10000000001
101         101   101    1         111111101   10000000001
101         101   101    1111111         101   10000000001
10111111    111111101    10000001   11111101   10000000001
10000001    100000001    10000001  100000001   1000000001 
11111111    111111111    11111111  111111111   111111111                     


