NO assets/textures/wall_north.png
SO assets/textures/wall_south.png
WE assets/textures/wall_west.png
EA assets/textures/wall_east.png

F 220,100,0
C 225,30,0

111111111
10S000001
100100001
100000001
111111111