NO assets/textures/tiles/wall_north.png
SO assets/textures/tiles/wall_south.png
WE assets/textures/tiles/wall_west.png
EA assets/textures/tiles/wall_east.png

F 220,100,0
C 225,30,0
A 0,0,0,5

111111111
10S000001
100100001
100000001
000000000

ENTITY 0,0.25,0.14,4,"qwedfghjkfksdnglksgnlesjlegnsdngk;nsklgndlnh"