A 0,0,0,0
NO assets/textures       /tiles/wall_north.png
SO assets/textures      /tiles/wall_south.png
WE assets/textures /tiles/wall_west.png
EA assets/textures /tiles/wall_east.png

F 255,0,0
C 0,0,0
11111111
10     1
11111111