##DOOR FEATURE TEST

#Textures
NO assets/textures/tiles/wall_north.png
SO assets/textures/tiles/wall_south.png
WE assets/textures/tiles/wall_west.png
EA assets/textures/tiles/wall_east.png

#Colors
F 180, 230, 98
C 250, 170, 120
A 250, 170, 120, 2

#TREE ENTITY

#-----------

#-------END PILLAR----------#

HEIGHT 13, 2, 5, 5, 8, 0
ENTITY CAKE,{15.5,4.5,9.25}

HEIGHT_PRECISE 16,7,1,1,0.2,-0.8
HEIGHT_PRECISE 17,7,1,1,1.8,0
HEIGHT_PRECISE 18,7,1,1,0.2,-2.4
HEIGHT_PRECISE 18,6,1,1,3.2,0
HEIGHT_PRECISE 18,5,1,1,0.2,-4
HEIGHT_PRECISE 18,4,1,1,4.9,0
HEIGHT_PRECISE 18,3,1,1,0.2,-5.5
HEIGHT_PRECISE 18,2,1,1,6.4,0
HEIGHT_PRECISE 18,1,1,1,6.4,0
HEIGHT_PRECISE 17,1,1,1,0.2,-6.7
HEIGHT_PRECISE 16,1,1,1,7.3,0
HEIGHT_PRECISE 15,1,1,1,0.2,-7.6

# OPEN 1
ENTITY DOOR,{13.8, 7.05, 1},[{16, 7}],0.8,0.01,true,false

# TEST Levers
ENTITY DOOR,{12, 22, 1},[{16, 7}],0.8,0.01,true,false
ENTITY DOOR,{14, 22, 1},[{18, 5}],3.8,0.05,true,false
ENTITY DOOR,{15, 22, 1},[{18, 3}],5.5,0.07,true,false
ENTITY DOOR,{16, 22, 1},[{17, 1}],6.7,0.09,true,false
ENTITY DOOR,{16, 22, 1},[{15, 1}],7.6,0.09,true,false

#----------ZONE 1--------------

ENTITY NPC,{15.5,18.5,1},"{4o}Jonathan: {T3l}Heyy! I am Jonathan  John's brother. I forgot my birthday cake on this cliff. Please help me! Maybe you want to use these {~i}levers. {*e}They are great for moving things."
ENTITY DOOR,{15.5, 16.5, 1},[{15, 15}],0.4,0.02,true,true

ENTITY NPC,{14.5,7.5,1},"{4o}Jimmy: {T3q}Why does this place have a cliff like that? We are literally in cub3d..."

HEIGHT_PRECISE 4, 3, 1, 1, 5, 0
HEIGHT 4, 4, 1, 1, 1.66

# PUZZLE 1
ENTITY DOOR,{3.5, 9.05, 1},[{4, 4}],1.8,0.2,true,true
ENTITY DOOR,{4, 9.05, 1},[{4, 4}],4.2,-0.2,true,true
ENTITY DOOR,{5.0, 9.05, 1},[{4, 4}],6.1,0.2,true,true
ENTITY DOOR,{5.5, 9.05, 1},[{4, 4}],0.66,-0.2,true,true
ENTITY DOOR,{4.5, 2.05, 1},[{4, 4}],0.66,0.2,true,true
ENTITY NPC,{6.5,9,1},"{4o}Jill: {T4y}DOES THESE               LEVERS LEVITATES??"

# OPEN 2
ENTITY DOOR,{4.5, 4.05, 1.5},[{18, 7}],2.4,0.03,true,false

# Block to access ZONE 2
HEIGHT 27, 10, 1, 1, 5, 3.25
HEIGHT 27, 12, 1, 1, 2, 0
HEIGHT 27, 14, 1, 1, 2.5, 0

# Barrier to protect cheat
HEIGHT_PRECISE 1, 0, 28, 1, 0.1, -0.2
HEIGHT 29, 8, 1, 13, 2.5, 0
HEIGHT 24, 16, 3, 1, 2.5, 0

#*****************************

1111111111111111111111111111111111111111111111111111111111111111111111111111111111111111111111111111111111111111111
1000000000000001010000000000010000000000000000000000000001000000000000000000000000000000000000000000000000000000001
10     000000000000000000000010000000000000000000000000001000000000000000000000000000000000000000000000000000000001
10  1  000000022201002200000010000000000000000000000000001000000000000000000000000000000000000000000000000000000001
10  0  000000020200022222000010000000000000000000000000001000000000000000000000000000000000000000000000000000000001
10     000000022201002222000010000000000000000000000000001000000000000000000000000000000000000000000000000000000001
10     000000000000000000000010000000000000000000000000001000000000000000000000000000000000000000000000000000000001
1000000000000000101000000000010000000000000000000000000001000000000000000000000000000000000000000000000000000000001
1000000000000000000000010000010000000000000000000000000001000000000000000000000000000000000000000000000000000000001
1000000000000000000000111000010000000000000000000000000001000000000000000000000000000000000000000000000000000000001
1000000000000000000000010000010000000000000000000000000001000000000000000000000000000000000000000000000000000000001
1000000000000000000000000000010000000000000000000000000001000000000000000000000000000000000000000000000000000000001
1000000000000000000000000000010000000000000000000000000001000000000000000000000000000000000000000000000000000000001
1000000222000000000000000000010000000000000000000000000001000000000000000000000000000000000000000000000000000000001
1000002222000000000000000000010000000000000000000000000001000000000000000000000000000000000000000000000000000000001
1000000000000000000000000000010000000000000000000000000001000000000000000000000000000000000000000000000000000000001
1111111111111100011111111111110000000000000000000000000001000000000000000000000000000000000000000000000000000000001
1000000000111100011110000000010000000000000000000000000001000000000000000000000000000000000000000000000000000000001
1000000000100000000010000000010000000000000000000000000000000000000000000000000000000000000000000000000000000000001
1000000000100000000010000000010000000000000000000000000000000000000000000000000000000000000000000000000000000000001
100000000010000N000010000000010000000000000000000000000000000000000000000000000000000000000000000000000000000000001
1000000000100000000010000000010000000000000000000000000000000000000000000000000000000000000000000000000000000000001
1000000000100000000010000000010000000000000000000000000001000000000000000000000000000000000000000000000000000000001
1000000000100000000010000000010000000000000000000000000001000000000000000000000000000000000000000000000000000000001
1000000000111111111110000000010000000000000000000000000001000000000000000000000000000000000000000000000000000000001
1000000000000000000000000000010000000000000000000000000001000000000000000000000000000000000000000000000000000000001
1000000000000000000000000000010000000000000000000000000001000000000000000000000000000000000000000000000000000000001
1000000000000000000000000000010000000000000000000000000001000000000000000000000000000000000000000000000011111111111
1000000000000000000000000000010000000000000000000000000001000000000000000000000000000000000000000000111100000000001
1000000000000000000000000000010000000000000000000000000001000000000000000000000000000000000000000111000000000000001
1000000000000000000000000000010000000000000000000000000001000000000000000000000000000000000000011000000000000000001
1111111111111111111111111111111111111111111111111111111111000000000000000000000000000000000000100000000000000000001
1000000000000000000000000000000000000000000000000000000000000000000000000000000000000000000001000000000000000000001
1000000000000000000000000000000000000000000000000000000000000000000000000000000000000000000010000000000000000000001
1000000000000000000000000000000000000000000000000000000000000000000000000000000000000000000100000000000000000000001
1111100000000000000000000000000000000000000000000000000000000000000000000000000000000000000100000000000000000000001
1000100000000000000000000000000000000000000000000000000000000000000000000000000000000000000100000000000000000000001
1000100000000000000000000000000000000000000000000000000000000000000000000000000000000000000100000000000000000000001
1000100000000000000000000000000000000000000000000000000000000000000000000000000000000000000100000000000000000000001
1111111111111111111111111111111111111111111111111111111111111111111111111111111111111111111111111111111111111111111