##DOOR FEATURE TEST

#Textures
NO assets/textures/tiles/wall_north.png
SO assets/textures/tiles/wall_south.png
WE assets/textures/tiles/wall_west.png
EA assets/textures/tiles/wall_east.png

#Colors
F 153, 247, 98
C 135, 206, 250
A 135, 206, 250, 2

ENTITY DOOR,{4.5, 4.95, 1},[{1, 2},{2, 1},{2, 2}],0.4,0.01,true,true,RANDOM

1111111111
1000000001
1000000001
1000S00001
1000000001
1000100001
1000000001
1111111111