##DOOR FEATURE TEST

#Textures
NO assets/textures/tiles/wall_north.png
SO assets/textures/tiles/wall_south.png
WE assets/textures/tiles/wall_west.png
EA assets/textures/tiles/wall_east.png

#Colors
F 180, 230, 98
C 250, 170, 120
A 250, 170, 120, 2

#TREE ENTITY

ENTITY TREE,{15.71, 1.83, 2.6}
ENTITY TREE,{4.36, 2.27, 2.6}
ENTITY TREE,{36.92, 2.14, 2.6}
ENTITY TREE,{37.58, 2.69, 2.6}
ENTITY TREE,{87.23, 4.91, 2.6}
ENTITY TREE,{34.17, 5.42, 2.6}
ENTITY TREE,{69.84, 5.76, 2.6}
ENTITY TREE,{9.39, 7.18, 2.6}
ENTITY TREE,{26.65, 7.53, 2.6}
ENTITY TREE,{44.12, 8.87, 2.6}
ENTITY TREE,{35.48, 10.29, 2.6}
ENTITY TREE,{2.73, 12.34, 2.6}
ENTITY TREE,{20.91, 14.67, 2.6}
ENTITY TREE,{49.38, 14.25, 2.6}
ENTITY TREE,{83.54, 14.89, 2.6}
ENTITY TREE,{5.19, 18.62, 2.6}
ENTITY TREE,{19.77, 18.43, 2.6}
ENTITY TREE,{36.31, 18.95, 2.6}
ENTITY TREE,{37.86, 18.28, 2.6}
ENTITY TREE,{37.44, 19.71, 2.6}
ENTITY TREE,{38.92, 19.36, 2.6}
ENTITY TREE,{39.57, 19.83, 2.6}
ENTITY TREE,{104.28, 19.64, 2.6}
ENTITY TREE,{24.13, 20.79, 2.6}
ENTITY TREE,{35.68, 20.45, 2.6}
ENTITY TREE,{36.24, 20.17, 2.6}
ENTITY TREE,{37.39, 20.82, 2.6}
ENTITY TREE,{49.75, 21.38, 2.6}
ENTITY TREE,{2.88, 24.56, 2.6}
ENTITY TREE,{5.43, 26.91, 2.6}
ENTITY TREE,{35.16, 26.27, 2.6}
ENTITY TREE,{17.72, 28.64, 2.6}
ENTITY TREE,{47.89, 28.31, 2.6}
ENTITY TREE,{68.35, 29.78, 2.6}
ENTITY TREE,{105.62, 33.49, 2.6}
ENTITY TREE,{106.17, 33.85, 2.6}
ENTITY TREE,{107.43, 33.26, 2.6}
ENTITY TREE,{108.79, 33.93, 2.6}
ENTITY TREE,{11.54, 34.67, 2.6}
ENTITY TREE,{43.28, 35.14, 2.6}
ENTITY TREE,{73.91, 35.58, 2.6}
ENTITY TREE,{105.37, 36.21, 2.6}
ENTITY TREE,{106.84, 36.75, 2.6}
ENTITY TREE,{107.29, 36.42, 2.6}
ENTITY TREE,{108.66, 36.89, 2.6}

#-----------

#End

HEIGHT 13, 2, 5, 5, 8, 0
ENTITY CAKE,{15.5,4.5,9.25}

ENTITY DOOR,{4.5, 4.95, 1},[{1, 2},{2, 1},{2, 2}],0.4,0.03,true,true,RANDOM
ENTITY NPC,{15.5,18.5,1},"{T3l}Heyy! I am Jonathan John's brother. I forgot my birthday cake on this cliff. Please help me! Maybe you want to use these {~i}levers.      {*e}They are great for moving things."
ENTITY DOOR,{16, 18.5, 1},[{16, 17}],0.4,0.02,true,true

HEIGHT 27, 10, 1, 1, 5, 3.25
HEIGHT 27, 12, 1, 1, 2, 0
HEIGHT 27, 14, 1, 1, 2.5, 0

HEIGHT 29, 10, 1, 11, 2.5, 0
HEIGHT 24, 16, 3, 1, 2.5, 0

1111111111111111111111111111111111111111111111111111111111111111111111111111111111111111111111111111111111111111111                        
1000000000000000000000000000010000000000000000000000000001000000000000000000000000000000000000000000000000000000001                         
1000000000000000000000000000010000000000000000000000000001000000000000000000000000000000000000000000000000000000001                          
1000000000000022200002200000010000000000000000000000000001000000000000000000000000000000000000000000000000000000001                          
1000000000000020200022222000010000000000000000000000000001000000000000000000000000000000000000000000000000000000001                          
1000000000000022200002222000010000000000000000000000000001000000000000000000000000000000000000000000000000000000001                          
1000000000000000000000000000010000000000000000000000000001000000000000000000000000000000000000000000000000000000001                          
1000000000000000000000000000010000000000000000000000000001000000000000000000000000000000000000000000000000000000001                          
1000000000000000000000010000010000000000000000000000000001000000000000000000000000000000000000000000000000000000001                          
1000000000000000000000111000010000000000000000000000000001000000000000000000000000000000000000000000000000000000001                          
1000000000000000000000010000010000000000000000000000000001000000000000000000000000000000000000000000000000000000001                         
1000000000000000000000000000010000000000000000000000000001000000000000000000000000000000000000000000000000000000001                          
1000000000000000000000000000010000000000000000000000000001000000000000000000000000000000000000000000000000000000001                          
1000000222000000000000000000010000000000000000000000000001000000000000000000000000000000000000000000000000000000001                          
1000002222000000000000000000010000000000000000000000000001000000000000000000000000000000000000000000000000000000001                          
1000000000000000000000000000010000000000000000000000000001000000000000000000000000000000000000000000000000000000001                          
1111111111111100011111111111110000000000000000000000000001000000000000000000000000000000000000000000000000000000001                        
1000000000111100011110000000010000000000000000000000000001000000000000000000000000000000000000000000000000000000001                                                  
1000000000100000000010000000010000000000000000000000000000000000000000000000000000000000000000000000000000000000001                                           
1000000000100000000010000000010000000000000000000000000000000000000000000000000000000000000000000000000000000000001                                               
100000000010000N000010000000010000000000000000000000000000000000000000000000000000000000000000000000000000000000001                                              
1000000000100000000010000000010000000000000000000000000000000000000000000000000000000000000000000000000000000000001                                             
1000000000100000000010000000010000000000000000000000000001000000000000000000000000000000000000000000000000000000001                                              
1000000000100000000010000000010000000000000000000000000001000000000000000000000000000000000000000000000000000000001                                               
1000000000111111111110000000010000000000000000000000000001000000000000000000000000000000000000000000000000000000001
1000000000000000000000000000010000000000000000000000000001000000000000000000000000000000000000000000000000000000001
1000000000000000000000000000010000000000000000000000000001000000000000000000000000000000000000000000000000000000001   
1000000000000000000000000000010000000000000000000000000001000000000000000000000000000000000000000000000011111111111   
1000000000000000000000000000010000000000000000000000000001000000000000000000000000000000000000000000111100000000001   
1000000000000000000000000000010000000000000000000000000001000000000000000000000000000000000000000111000000000000001                                    
1000000000000000000000000000010000000000000000000000000001000000000000000000000000000000000000011000000000000000001   
1111111111111111111111111111111111111111111111111111111111000000000000000000000000000000000000100000000000000000001
1000000000000000000000000000000000000000000000000000000000000000000000000000000000000000000001000000000000000000001
1000000000000000000000000000000000000000000000000000000000000000000000000000000000000000000010000000000000000000001
1000000000000000000000000000000000000000000000000000000000000000000000000000000000000000000100000000000000000000001
1111100000000000000000000000000000000000000000000000000000000000000000000000000000000000000100000000000000000000001
1000100000000000000000000000000000000000000000000000000000000000000000000000000000000000000100000000000000000000001
1000100000000000000000000000000000000000000000000000000000000000000000000000000000000000000100000000000000000000001
1000100000000000000000000000000000000000000000000000000000000000000000000000000000000000000100000000000000000000001
1111111111111111111111111111111111111111111111111111111111111111111111111111111111111111111111111111111111111111111