
##Level 1 - [32mA Journey for John[0m

#Textures
NO assets/textures/tiles/wall_north.png
SO assets/textures/tiles/wall_south.png
WE assets/textures/tiles/wall_west.png
EA assets/textures/tiles/wall_east.png

#Colors
F 153, 247, 98
C 135, 206, 250
A 135, 206, 250, 2

#NPC
ENTITY NPC,{9.5,4.5,0.95},"{T3~=}Hey I am John.{~=e} It’s my friend Johny's birthday. Please wish him a happy birthday for me. He’s on the other side of the void. Thank you."
ENTITY NPC,{10.5,21.9,0.95}

#Reset Map Height after spawn
HEIGHT_PRECISE 9,4,3,1,0.2,0
HEIGHT_PRECISE 0,5,200,200,0.2,0

#Tree areas

# left
ENTITY TREE,{1.5,7.5,2.8}
HEIGHT 1,7,1,1,0.2

ENTITY TREE,{1.5,11.5,2.8}
HEIGHT 1,11,1,1,0.2

ENTITY TREE,{1.5,15.5,2.8}
HEIGHT 1,15,1,1,0.2

ENTITY TREE,{1.5,19.5,2.8}
HEIGHT 1,19,1,1,0.2

# right
ENTITY TREE,{19.5,7.5,2.8}
HEIGHT 19,7,1,1,0.2

ENTITY TREE,{19.5,11.5,2.8}
HEIGHT 19,11,1,1,0.2

ENTITY TREE,{19.5,15.5,2.8}
HEIGHT 19,15,1,1,0.2

ENTITY TREE,{19.5,19.5,2.8}
HEIGHT 19,19,1,1,0.2
#------------------------

#Jump
HEIGHT 8,11,1,1,0.68,0.4

HEIGHT 10,10,6,1,0.9,0.85

HEIGHT 13,10,1,1,-0.2

HEIGHT 16,10,1,1,-0.4

HEIGHT 14,19,1,1,-2
HEIGHT 12,18,1,1,-2
HEIGHT 9,18,1,1,-2.1
HEIGHT 8,19,1,1,-1.5,-2.0
HEIGHT 6,18,1,1,-0.8,-2.0
HEIGHT 3,19,1,1,-0.47,-2.0

HEIGHT 4,15,10,1,0.4
HEIGHT 6,15,1,1,0.15
HEIGHT 9,15,1,1,0.2
HEIGHT 12,15,1,1,0.2

HEIGHT 12,17,1,1,0.6
HEIGHT 12,19,1,1,0.8

#------------------------

#Map
      111111111
      120000021
      1200S0021
      120000021
      111111111
          1         
111               111
101        1      101
111               111
          1          
111       1  1  1 111
101     1         101
111               111
                     
111               111
101 1 1  1  1     101
111               111
            1        
111   1  1  1     111
1011    1   1 1   101
111               111
         111         
        12021
        12021
         111