NO assets/textures/tiles/wall_north.png
SO assets/textures/tiles/wall_south.png
WE assets/textures/tiles/wall_west.png
EA assets/textures/tiles/wall_east.png

F 220,100,0
C 225,30,0
A 0,0,0,5

11111111111111111111
10S000000000000     
10010000000000000001
10000000111111111111
111111111         
E