##Level 1 - [31mHello World[0m
##Test waouh 
##This is a broadcast
##

#Textures
NO assets/textures/tiles/wall_north.png
SO assets/textures/tiles/wall_south.png
WE assets/textures/tiles/wall_west.png
EA assets/textures/tiles/wall_east.png

#Colors
F 250, 24, 250, [[[false]]]
C 135, 206, 250
A 135, 206, 200, 370

#Tilemap
#
# Writing cub3d was difficult, i almost cried.
# So i let this poem right there to show an exemple of comments :
#
# In self-defense
# A knife protects
# I bring my lunch
# No one suspects
# And when its time
# Deceptive fruit
# Banana Knife
#

11111111111 1111111111111
1E0000000111000000000001
1011000001110000000000001
1011000001110000000000001
100100000000000000000000111111111
111111111011000001110000000000001
111111111011000001110000000000001
111111111011000001110000000000001
100000000111000001110111111111111
1111011111 111011100000010001 
11110111111111011101010010001111111111111111111111
11000000110101011100000000000000000000000000010001
11000000110101011100000000000002222000000000010001
11000000110101011100000000000000222200000000010001
11000000110101011100000000000000022000000000010001
11100000000000001100000000000000000000000000000001
   100000000000000011010000000000000000000000100101
111000011101010111110111100011111111111111111111111
10000011 1110101 101111010001
11111111 1111111 111111111111
