NO assets/cmoore6.png
SO assets/cmoore6.png
WE assets/cmoore6.png
EA assets/cmoore6.png

F 0,255,0
C 0,255,255

11111111111 1111111111111
1P00000000111000000000001
1011000001110000000000001
1011000001110000000000001
100100000000000000000000111111111
111111111011000001110000000000001
111111111011000001110000000000001
111111111011000001110000000000001
1E0000000111000001110111111111111
1111011111 111011100000010001 
11110111111111011101010010001111111111111111111111
11000000110101011100000000000000000000000000010001
11000000110101011100000000000000000000P00000010001
11000000110101011100000000000000000000000000010001
11000000110101011100000000000000000000000000010001
111000000000000011000000000000000000000000000000001
   100000000000000011010000000000000000000000100101
111000011101010111110111100011111111111111111111111
10000011 1110101 101111010001
11111111 1111111 111111111111